2 2
*****
*E-□*
*|*|*
*□-▨*
*****