6 6
*************
*E-□-□-□-□-□*
***********|*
*□-□-□-□-□-□*
*|***********
*□-□-□-□-□-□*
***********|*
*□-□-□-□-□-□*
*|***********
*□-□-□-□-□-□*
***********|*
*▨-□-□-□-□-□*
*************
